Your adventure leads you and your fellow companions, recently titled the Fellowship of the Ring, to the West Gate of Khazad-dûm. The Fellowship consists of Gandalf the Grey Wizard, Aragorn the Ranger, Legolas the Elf, Boromir, a man of Gondor, Gimli the Dwarf, and your fellow Hobbits Sam, Pippin, and Merry. Khazad-dûm, now referred to as the Mines of Moria, is an old home to the Dwarves and is revered for its grand size and beauty. The West Gate entrance is an old and almost forgotten one. Your party wishes to enter and use it as a swift and unobserved path towards Mordor. However, it seems the way is shut, requiring a password for entry...

Adventure-Through-Moria
An Interactive Fiction by Andrew Davis and Ryan McGuire
Release 1 / Serial number 120922 / Inform 7 build 6G60 (I6/v6.32 lib 6/12N) SD

West Gate
You can see a Durin Doors here.

>l Pippin
Tall

>take pipeweed from Pippin
That seems to belong to now Pippin.

>take pipeweed
That seems to belong to now Pippin.

>l Pippin
Tall

>l Merry
Short

>l The Fellowship
You can't see any such thing.

>pippin
Tall

>open door
It seems to be locked.

>ask Legolas about elvish
Legolas says, "Sure friend, I'd be happy to help. Here's my Elvish-to-English translator that I use to better understand those around me."

 The Elvish-to-English Translator has been added to your inventory!

>i
You are carrying:
  an Elvish-to-English Translator

>door
Stone door with elvish writing atop, "Speak, "friend" and Enter"

Gandalf says that the elvish atop the door seems to be a riddle
Speak the password

>mellon
The star shone out briefly and faded again. Then silently a great doorway was outlined, through not a crack or joint had been visible before. Slowly it divided in the middle and swung outwards inch by inch, until both doors lay back against the wall.

>east
First Hall of Moria
You can see a Durin Doors here.

>east
Mithril Forge

>door
That's not a verb I recognise.

>mellon
That's not a verb I recognise.

>east
Armory

* * *

>door
Stone door with elvish writing atop, "Speak, "friend" and Enter"

Gandalf says that the elvish atop the door seems to be a riddle
Speak the password

>asdf
The silver lines faded, but the blank grey stone did not stir. Gandalf wonders if you should ask Legolas about elvish.

Would you like to try another password? (Yes or No)

* * *

>ask Legolas about elvish
Legolas says, "Sure friend, I'd be happy to help. Here's my Elvish-to-English translator that I use to better understand those around me."

 The Elvish-to-English Translator has been added to your inventory!

>l translator
You open the book...
Elvish       ->  English
-----------------------
Ruth        ->  Anger 
Dagor      ->  Battle 
Hîni         -†>  Children 
Nogoth   ->  Dwarf 
Edhel       ->  Elf 
Mellon    ->  Friend 
Anna       ->  Gift 
Thôl        -
>  Helmet 
Heleg      ->  Ice 
Lenn        ->  Journey 
Aran        ->  King 
Galad      ->  Light 
Adan       ->  Man 
Neder      ->  Nine 
Min         ->  One 
Gwaith    ->  People 
Bereth     ->  Queen 
Cor          ->  Ring 
Dae          ->  Shadow 
Barad      ->  Tower 
Nu           ->  Under 
Imlad      ->  Valley 
Ohtar      ->  Warrior 
Neth        ->  Youth

>door
Stone door with elvish writing atop, "Speak, "friend" and Enter"

Gandalf says that the elvish atop the door seems to be a riddle
Speak the password

* * *

>east
First Hall of Moria
You can see a Durin Doors here.

>open crate
You open the crate.

* * *

>east
First Hall of Moria
You can see a Durin Doors here.

>search
You wander around the room in the dark and stumble on an old crate. Maybe you can open it.

>open crate
You open the crate.